1111111111111111111111111111111111
1E0000000000000C00001C100100000001
1010010100100000101001000100010101
1010010010101010001001000100010101
1P0000000C00C0000000000000010000C1
1111111111111111111111111111111111